R          1080        720

WE ./textures/aka1024.xpm      
SO ./textures/wall.xpm
EA ./textures/luffy1024.xpm
S ./textures/zombie.xpm


F 96,96,96
C          204,255,255

NO ./textures/stone.xpm







        1111111111111111111111111111
        1110000020000000002111111111
      1110200000000000002000000001
        11100000000110000000000011
      1111100000000200000000000000111111
          1111100000000000000000000000111111
          111110000000000000000000000111111
          111110000000000000000000000111111
          111110000000000000000000000111111
        111110000000000000000000000111111
          1111100E000022222222200000000111111
      111110000000000000000000000111111
          111110000000000000000000000111111
        111110000000000000000000000111111
          11111111111111111111111111111