R          1080        720

WE ./textures/aka1024.xpm
SO ./textures/wall.xpm
EA ./textures/luffy1024.xpm
S ./textures/barrel.xpm


F 96,96,96
C          204,255,255

NO ./textures/stone.xpm






111111111
        1111111111111111111111111111
        11100000200000000211111111
      11100000S0000000002000000001
        111000000000110000000000011
      11111000000020000000000000011
          11111111111111111111111111111