R          940        610

WE ./textures/.xpm
SO ./textures/brick.xpm
EA ./textures/mossy.xpm
S ./textures/barrel.xpm


F 0,0,0
C 0,100,055

NO ./textures/wood.xpm






    11111111111111111
1111110000020000111111
   11111110000000001
11110000000N00001111
11100200000000001
  11111111111111111