R  1080 720

WE ./textures/mossy.xpm      
SO ./textures/wall.xpm
EA ./textures/redbrick.xpm
S ./textures/zombie.xpm


F 96,96,96
C          220, 235,235

NO ./textures/stone.xpm

1111111111111
          111111111111111111
          1111 100020111
          11111 11000011111
          11 1 11100S000111
          1111 1 1000011111
          11 11111102000011111
          11111 1 11111111111