R  1080 720

WE ./textures/aka1024.xpm      
SO ./textures/wall.xpm
EA ./textures/luffy1024.xpm
S ./textures/zombie.xpm


F 0,0,0
C 204, 255,255

NO ./textures/stone.xpm




            1111111111111111
            1000000000000001
            1000000000000001
            1000000000000001
1111111111111000000000000001
1000000000000000000000000001
1110000000222222200000000011
1100000020000000000000000111
100000200000000000111110011
10000200000000000000000001111
1000200000000N000000000000111
1111111111111111111111111111